##################
# @@@@@          #
# @d07@          #
# @@@@@     ## # #
#           ##   #
##################
