################################
#@@@@@      &&&&&              #
#@d07@      &g45&              #
#@@@@@      &&&&&             #
#           ##   @@@@@         #
#           ##   @h45@  #      #
#           ##   @@@@@###      #
#     &&&&& %%%%%   ###        #
#     &y45& %B72%   #          #
#     &&&&& %%%%%   #          #
################################
