################################
#           ##   @@@@@         #
#           ##   @h45@  #      #
#           ##   @@@@@###      #
# @@@@@      &&&&&             #
# @d07@      &g45&             #
# @@@@@      &&&&&             #
#     &&&&& %%%%%   ###        #
#     &y45& %B72%   #          #
#     &&&&& %%%%%   #          #
################################
