#####################
#@@@@@      &&&&&   #
#@d07@      &g45&   #
#@@@@@      &&&&&   #
#           ##      #
#           ##      #
#           ##      #
#           %%%%%   #
#           %B72%   #
#           %%%%%   #
#####################
