################################
#@@@@@      &&&&&              #
#@d07@      &d45&              #
#@@@@@      &&&&&              #
#           ##   @@@@@         #
#           ##   @h45@  #      #
#           ##   @@@@@###      #
#     &&&&& %%%%%   ###        #
#     &y45& %B72%   #          #
#     &&&&& %%%%%   #          #
################################
