################################
#@@@@@      &&&&&              #
#@d07@      &g45&              #
#@@@@@      &&&&&              #
#           ##   @@@@@         #
#           ##   @h45@  #      #
#           ##   @@@@@###      #
#     &&&&& %%%%%   ###        #
#     &B45& %B72%   #          #
#     &&&&& %%%%%   #          #
################################
