################################
#@@@@@      &&&&&              #
#@d07@      &g45&              #
#@@@@@      &&&&&              #
#     &&&&& %%%%%   ###        #
#     &y45& %B72%   #          #
#     &&&&& %%%%%   #          #
#           ##   @@@@@         #
#           ##   @h45@  #      #
#           ##   @@@@@###      #
################################
