################################
#@@@@@      &&&&&              #
#@d07@      &g45&              #
#@@@@@      &&&&&              #
#           ##   @@@@@         #
#           ##   @h45@  #      #
#           ##   @@@@@###      #
#     &&&&&  %%%%%   ###       #
#     &y145& %B72%   #         #
#     &&&&&  %%%%%   #         #
################################
