################################
#@@@@@      &&&&&        #######
#@d20@      &g01&        #######
#@@@@@  #   &&&&&        #     #
#       #        @@@@@   #     #
#     #### ###   @h15@  #      #
#           ##   @@@@@###      #
# ##  &&&&& %%%%%   ###        #
#  #  &y01& %B01%   #          #
#     &&&&& %%%%%   #          #
################################
