#####################
#@@@@@      &&&&&   #
#@d15@      &g00&   #
#@@@@@      &&&&&   #
#           ##      #
#           ##      #
#           ##      #
#           %%%%%   #
#           %B11%   #
#           %%%%%   #
#####################
