################################
#@@@@@      &&&&&              #
#@d99@      &g12&              #
#@@@@@      &&&&&              #
#                @@@@@         #
#                @h99@         #
#                @@@@@         #
#     &&&&& %%%%%              #
#     &y12& %B99%              #
#     &&&&& %%%%%              #
################################
